
11111111111111
1P01000O000OC1
10000O11011111
1000O000000OE1
1C001100000011
1000OC0000C001
11111111111111