11111111111111111111
1P010000000C100100E1
10000O11110000010001
1000110000010O000001
1C001100000100100001
1000OC0000C10010O001
1O0011O000010010OC01
10001C0000100000O001
100OC01000C000100001
11111111111111111111